0,0,0,5,0,9,0,0,0
1,0,0,0,0,0,7,0,0
0,5,0,0,7,2,0,0,6
7,8,0,0,0,6,9,3,0
0,0,0,0,4,0,0,0,0
0,2,9,7,0,0,0,6,5
5,0,0,8,1,0,0,4,0
0,0,4,0,0,0,0,0,7
0,0,0,4,0,3,0,0,0