0,0,3,1,0,5,0,7,0
0,0,2,0,9,7,8,0,0
0,5,0,0,8,4,9,0,2
0,4,0,2,0,0,3,0,0
0,2,0,5,0,9,0,4,0
0,0,9,0,0,3,0,1,0
2,0,4,7,5,0,0,8,0
0,0,6,4,1,0,5,0,0
0,1,0,9,0,8,6,0,0